# #################
#  # # # ## #     #
## #     ##   # # #
#  # ####### ######
##   #     # # # ##
#  # # ##### #.*, #
# ##    # ##  ;####
###  ##      #.,, #
#   #### # # # ##,#
#################,#
