# #################
#  # # # ## #     #
## #     ##   # # #
#  # ####### ######
##   #     # # # ##
#  # # ##### #    # 
# ##    # ##   ####
###  ##      #    #
#   #### # # # ## #
################# #
