# #################
#  # # # ## #     #
## #....+##*. # # #
#  #.#######.######
##  .#     #.# # ##
#  #.# #####.#    #
# ##....# ##.  ####
###  ##......#    #
#   #### # # # ## #
################# #
