#,##############################################################################
#,# #  # # # # # # ##    ## ##  # ##    #  ## ##   ## ## ##  ## # # ##  # ## # #
#,# ##   # # #   # #  ##### ## ##  ### ## ###  ## ### ## ## ### #   ### #  # # #
#,# ####   # # ###   #####  #     ##        ## ##  #  #  ## # #   #  ## # ## # #
#,#  #####   # # ### ##  ## ### ##### ########  ## # ## ### # ### ####  #  #   #
#,# ##  #### # #  ##  # ##  # #   ##   # # #   ##       ##  # # #  # ## ##   ###
#,#  ##  ### #   #### #  ##   # ##### ##   # ######## ###  ## # # ## ## #  #   #
#,,,##  ## # ## ## ## # #####     ##   # ###  # # ##  # ## ## # # ## ## # ### ##
###,## ##    #  ## ## #  # ## ###  ### #   # ## # ### # #  ## # # ## ## #   #  #
# ,,#   #### ## ## #  # ## #   ######  # ### ##   #     ##  # # #  # ## # ######
##,## ### #     ## ## # ## ###  ### ##   # #  ### # ###  ##   # ## # #     # # #
# ,,# ##    ###  #  # # ## # # ## #  ## ##   ## # # #   #### ## ## # # ###     #
###,#  ### #####   ## # ##     ## # ##     ####   ##### ##   ## #        # #####
#  ,##  ##### ## #    #  ### #  # #    # ###  ### ##    ####      ## # ###     #
# #,,,,## #    ### ##   ## #### # # ####   ## # #  ####  # ### #######   # ### #
######,#  #### ###### ###   ### #    #### ##  # ##      ##   #     ##########  #
###   ,# ##  # # ##   # ###  #  # ####  #  ##    ######  ### # ###          ## #
# ## #,#  ## # #  ###    ### ## #  # ## ###### # #  ##  ###  #   # # ### ##### #
# ####,# ##  # ## ######  ## ## # ##     ### # #### ### # # ## ############# ###
# # # ,,,,## # #  # #  ##  # #  #    # ### # #  ##  # # #   #     # #   ##     #
# # #####,,# #*## #   ##  ## ##   # ######     ####     ## ## #####   #### ## ##
#    ## ##,# #;#  ## #### ## ## ##### ## #####    ##### #     ##  # #####  #####
## #      ,,,#;# ##   ##     ##   ##      # ## ###### # #####    ##  ## ##   # #
#  #########,#;..####  ##### #  # ### #####  #  # # #    ###  # ### ### ## ### #
####        ,,,#. # ##  # #    ####    #  ## # ## # ####     ##         ##  ## #
# ####### ## ###.##  ## # ####  #### #   ##  # ## #    ### ############### ##  #
#  ##     ##### ..# ##  # # ## ## #  ###### ## ## ## ### #            ## #  ## #
## #### ### # ###... ## # # #  #  # ### ##  ##  # ## # # # ### ## # # ## # ##  #
#   # ###       ###.##    # ## # ## ##   ##  # ## ## #       # ########     # ##
### #  ####### ## ..## ## #       #  ## ####   ##    # ## # ## #  ## ##### ##  #
#   ## # # # # ###.###### #### #### ##   # # ###  ##    ######## ##   ## #    ##
### ## # # #    #..  ###  # ## # #   ### #   # ####  # ##### ##   ## ##  # #####
#    # # # #### #.## # ##   #      # # # ###    ##  ####  #     ####    ##     #
####        ##   . ### ####   ######## #  ## ###### # ###   #####  # ##### #####
#    ### ##  ####.###   ### #  #  # #  # ##   # ##  #     ###  ### # # #       #
############  # #.  ## ## ####   ## ## #  ## ##  ##   # #   ##  ## #     ## # ##
#       #####   #.###  ## ## # #  # #  # ##     ##  # ######## ##  # ###########
### # #  ## ###  .# # ### ## ### ## ##    ## ####  ##### ###    ##        ## # #
# ######        #.....# # #  ##   # #  # ##  ## ##   # # # ### ### ########    #
# ## # ## ###########...#   ##### # # ######  # ## ###     ##  #     #      # ##
#      ##### ##  ###  #...### ### # #  ### ##    # # # #######   ##### #########
######  ###   ## # ######.  # # #     ## #  ## ### #    ## ##  ### #           #
#### # ## ###    # # # # .### # ### #### # ##  # # # ####  ## ## #   ###### ## #
#       # # # ## # # # ##.# # # # # ## #   ###   # # # ###  # ## # ###  ########
####### # # ####     #   .....# # # #  # ###   ### #....### # #      ## # ##  ##
#   # #      # ## ## ########..     # ## # ### # #...##.....$   ## ####    ##  #
###   ## # #      ##  ### # ##.## ###    # #.......#  ##### # # #### #  ## #  ##
# ### ######### # ###        #.####   #### #.#### #############        ##### ###
#       # #   # ### # ###### #.# ####  ###... ######          ## # # ###  ## # #
####### # ###   ### ###      #.#  ##  ##  .####  # ## ## ######### #     ##    #
#             # #   ###### #  ...####  ###.# #  ## ## #####      # #####    ## #
## ### ## # # ### #        #####.  ## ## #.#   ##   # # #   # ####     # ## ####
#  ##   ##### #   # ###### #   #.###   # #.# #### ### #   # #    # ## ##  #    #
################ #### # #### #  .# # ### #.#    #       ##### ########## ### ###
# # # # # #   ######     ##### #.....##  #.# #### ### #    ###### # ## ### #   #
#           ### # #  # #   #########..# ##.        #### #### ## #          # # #
#### # # ##  #      ## ## ## ## # ###..  #.## ####    ### ## #    ########## # #
#    # #####   # ########       # # ##.###.######## ####   # ## #### # # ##### #
# ## # #     # # #        ## ##       .....       #      #                  ## #
############################################################################## #
