#,##############################################################################
#,# #  # # # # # # ##    ## ##  # ##    #  ## ##   ## ## ##  ## # # ##  # ## # #
#,# ##   # # #   # #  ##### ## ##  ### ## ###  ## ### ## ## ### #   ### #  # # #
#,# ####   # # ###   #####  #     ##        ## ##  #  #  ## # #   #  ## # ## # #
#,#  #####   # # ### ##  ## ### ##### ########  ## # ## ### # ### ####  #  #   #
#,# ##  #### # #  ##  # ##  # #   ##   # # #   ##       ##  # # #  # ## ##   ###
#,#  ##  ### #   #### #  ##   # ##### ##   # ######## ###  ## # # ## ## #  #   #
#,,,##  ## # ## ## ## # #####     ##   # ###  # # ##  # ## ## # # ## ## # ### ##
###,## ##    #  ## ## #  # ## ###  ### #   # ## # ### # #  ## # # ## ## #   #  #
# ,,#   #### ## ## #  # ## #   ######  # ### ##   #     ##  # # #  # ## # ######
##,## ### #     ## ## # ## ###  ### ##   # #  ### # ###  ##   # ## # #     # # #
# ,,# ##    ###  #  # # ## # # ## #  ## ##   ## # # #   #### ## ## # # ###     #
###,#  ### #####   ## # ##     ## # ##     ####   ##### ##   ## #        # #####
#  ,##  ##### ## #    #  ### #  # #    # ###  ### ##    ####      ## # ###     #
# #,,,,## #    ### ##   ## #### # # ####   ## # #  ####  # ### #######   # ### #
######,#  #### ###### ###   ### #    #### ##  # ##      ##   #     ##########  #
###   ,# ##  # # ##   # ###  #  # ####  #  ##    ######  ### # ###          ## #
# ## #,#  ## # #  ###    ### ## #  # ## ###### # #  ##  ###  #   # # ### ##### #
# ####,# ##  # ## ######  ## ## # ##     ### # #### ### # # ## ############# ###
# # # ,,,,## # #  # #  ##  # #  #    # ### # #  ##  # # #   #     # #   ##     #
# # #####,,# # ## #   ##  ## ##   # ######     ####     ## ## #####   #### ## ##
#    ## ##,# # #  ## #### ## ## ##### ## #####...$##### #     ##  # #####  #####
## #      ,,,# # ##   ##     ##   ##      # ##.###### # #####    ##  ## ##   # #
#  #########,#,,,####  ##### #  # ### #####  #. # # #    ###  # ### ### ## ### #
####        ,,,#, # ##  # #    ####    #  ## #.## # ####     ##         ##  ## #
# ####### ## ###,##  ## # ####  #### #   ##  #.## #    ### ############### ##  #
#  ##     ##### ,,# ##  # # ## ## #  ###### ##.## ## ### #            ## #  ## #
## #### ### # ###,,, ## # # #  #  # ### ##  ##. # ## # # # ### ## # # ## # ##  #
#   # ###       ###,##    # ## # ## ##   ##  #.## ## #       # ########     # ##
### #  ####### ## ,,## ## #       #  ## ####...##    # ## # ## #  ## ##### ##  #
#   ## # # # # ###,###### #### #### ##   # #.###  ##    ######## ##   ## #    ##
### ## # # #    #,,  ###  # ## # #   ### #  .# ####  # ##### ##   ## ##  # #####
#    # # # #### #,## # ##   #      # # # ###.   ##  ####  #     ####    ##     #
####        ##   , ### ####   ######## #  ##.###### # ###   #####  # ##### #####
#    ### ##  ####,### ;*### #  #  # #  # ## . # ##  #     ###  ### # # #       #
############  # #,  ##;## ####   ## ## #  ##.##  ##   # #   ##  ## #     ## # ##
#       #####   #,###;;## ## # #  # #  # ## .   ##  # ######## ##  # ###########
### # #  ## ###  ,# #;### ## ### ## ##    ##.####  ##### ###    ##        ## # #
# ######        #,,,,;# # #  ##   # #  # ## .## ##   # # # ### ### ########    #
# ## # ## ###########...#   ##### # # ######..# ## ###     ##  #     #      # ##
#      ##### ##  ###  #...### ### # #  ### ##..  # # # #######   ##### #########
######  ###   ## # ######.  # # #     ## #  ##.### #    ## ##  ### #           #
#### # ## ###    # # # # .### # ### #### # ## .# # # ####  ## ## #   ###### ## #
#       # # # ## # # # ##.# # # # # ## #   ###.  # # # ###  # ## # ###  ########
####### # # ####     #   .....# # # #  # ###  .### #    ### # #      ## # ##  ##
#   # #      # ## ## ########..     # ## # ###.# #   ##         ## ####    ##  #
###   ## # #      ##  ### # ##.## ###    # #...    #  ##### # # #### #  ## #  ##
# ### ######### # ###        #.####   #### #.#### #############        ##### ###
#       # #   # ### # ###### #.# ####  ###... ######          ## # # ###  ## # #
####### # ###   ### ###      #.#  ##  ##  .####  # ## ## ######### #     ##    #
#             # #   ###### #  ...####  ###.# #  ## ## #####      # #####    ## #
## ### ## # # ### #        #####.  ## ## #.#   ##   # # #   # ####     # ## ####
#  ##   ##### #   # ###### #   #.###   # #.# #### ### #   # #    # ## ##  #    #
################ #### # #### #  .# # ### #.#    #       ##### ########## ### ###
# # # # # #   ######     ##### #.....##  #.# #### ### #    ###### # ## ### #   #
#           ### # #  # #   #########..# ##.        #### #### ## #          # # #
#### # # ##  #      ## ## ## ## # ###..  #.## ####    ### ## #    ########## # #
#    # #####   # ########       # # ##.###.######## ####   # ## #### # # ##### #
# ## # #     # # #        ## ##       .....       #      #                  ## #
############################################################################## #
