# ##############################################################################
# # #  # # # # # # ##    ## ##  # ##    #  ## ##   ## ## ##  ## # # ##  # ## # #
# # ##   # # #   # #  ##### ## ##  ### ## ###  ## ### ## ## ### #   ### #  # # #
# # ####   # # ###   #####  #     ##        ## ##  #  #  ## # #   #  ## # ## # #
# #  #####   # # ### ##  ## ### ##### ########  ## # ## ### # ### ####  #  #   #
# # ##  #### # #  ##  # ##  # #   ##   # # #   ##       ##  # # #  # ## ##   ###
# #  ##  ### #   #### #  ##   # ##### ##   # ######## ###  ## # # ## ## #  #   #
#   ##  ## # ## ## ## # #####     ##   # ###  # # ##  # ## ## # # ## ## # ### ##
### ## ##    #  ## ## #  # ## ###  ### #   # ## # ### # #  ## # # ## ## #   #  #
#   #   #### ## ## #  # ## #   ######  # ### ##   #     ##  # # #  # ## # ######
## ## ### #     ## ## # ## ###  ### ##   # #  ### # ###  ##   # ## # #     # # #
#   # ##    ###  #  # # ## # # ## #  ## ##   ## # # #   #### ## ## # # ###     #
### #  ### #####   ## # ##     ## # ##     ####   ##### ##   ## #        # #####
#   ##  ##### ## #    #  ### #  # #    # ###  ### ##    ####      ## # ###     #
# #    ## #    ### ##   ## #### # # ####   ## # #  ####  # ### #######   # ### #
###### #  #### ###### ###   ### #    #### ##  # ##      ##   #     ##########  #
###    # ##  # # ##   # ###  #  # ####  #  ##    ######  ### # ###          ## #
# ## # #  ## # #  ###    ### ## #  # ## ###### # #  ##  ###  #   # # ### ##### #
# #### # ##  # ## ######  ## ## # ##     ### # #### ### # # ## ############# ###
# # #     ## # #  # #  ##  # #  #    # ### # #  ##  # # #   #     # #   ##     #
# # #####  # # ## #   ##  ## ##   # ######     ####     ## ## #####   #### ## ##
#    ## ## # # #  ## #### ## ## ##### ## #####    ##### #     ##  # #####  #####
## #         # # ##   ##     ##   ##      # ## ###### # #####    ##  ## ##   # #
#  ######### #   ####  ##### #  # ### #####  #  # # #    ###  # ### ### ## ### #
####           #  # ##  # #    ####    #  ## # ## # ####     ##         ##  ## #
# ####### ## ### ##  ## # ####  #### #   ##  # ## #    ### ############### ##  #
#  ##     #####   # ##  # # ## ## #  ###### ## ## ## ### #            ## #  ## #
## #### ### # ###    ## # # #  #  # ### ##  ##  # ## # # # ### ## # # ## # ##  #
#   # ###       ### ##    # ## # ## ##   ##  # ## ## #       # ########     # ##
### #  ####### ##   ## ## #       #  ## ####   ##    # ## # ## #  ## ##### ##  #
#   ## # # # # ### ###### #### #### ##   # # ###  ##    ######## ##   ## #    ##
### ## # # #    #    ###  # ## # #   ### #   # ####  # ##### ##   ## ##  # #####
#    # # # #### # ## # ##   #      # # # ###    ##  ####  #     ####    ##     #
####        ##     ### ####   ######## #  ## ###### # ###   #####  # ##### #####
#    ### ##  #### ###   ### #  #  # #  # ##   # ##  #     ###  ### # # #       #
############  # #   ## ## ####   ## ## #  ## ##  ##   # #   ##  ## #     ## # ##
#       #####   # ###  ## ## # #  # #  # ##     ##  # ######## ##  # ###########
### # #  ## ###   # # ### ## ### ## ##    ## ####  ##### ###    ##        ## # #
# ######        #     # # #  ##   # #  # ##  ## ##   # # # ### ### ########    #
# ## # ## ###########   #   ##### # # ######  # ## ###     ##  #     #      # ##
#      ##### ##  ###  #   ### ### # #  ### ##    # # # #######   ##### #########
######  ###   ## # ######   # # #     ## #  ## ### #    ## ##  ### #           #
#### # ## ###    # # # #  ### # ### #### # ##  # # # ####  ## ## #   ###### ## #
#       # # # ## # # # ## # # # # # ## #   ###   # # # ###  # ## # ###  ########
####### # # ####     #        # # # #  # ###   ### #    ### # #      ## # ##  ##
#   # #      # ## ## ########       # ## # ### # #   ##         ## ####    ##  #
###   ## # #      ##  ### # ## ## ###    # #       #  ##### # # #### #  ## #  ##
# ### ######### # ###        # ####   #### # #### #############        ##### ###
#       # #   # ### # ###### # # ####  ###    ######          ## # # ###  ## # #
####### # ###   ### ###      # #  ##  ##   ####  # ## ## ######### #     ##    #
#             # #   ###### #     ####  ### # #  ## ## #####      # #####    ## #
## ### ## # # ### #        #####   ## ## # #   ##   # # #   # ####     # ## ####
#  ##   ##### #   # ###### #   # ###   # # # #### ### #   # #    # ## ##  #    #
################ #### # #### #   # # ### # #    #       ##### ########## ### ###
# # # # # #   ######     ##### #     ##  # # #### ### #    ###### # ## ### #   #
#           ### # #  # #   #########  # ##         #### #### ## #          # # #
#### # # ##  #      ## ## ## ## # ###    # ## ####    ### ## #    ########## # #
#    # #####   # ########       # # ## ### ######## ####   # ## #### # # ##### #
# ## # #     # # #        ## ##                   #      #                  ## #
############################################################################## #
